 #################################################
#                                                #
#           G               G                    #
#                                          G     #
#EEEEEE                                          #
#     #####################################WWW###
# @@@ #                                   ^      #
# @ @ #                                   ^      #
# @@@ #            S              S       ^    2 #
#     #                                   ^      #
 ######QQQQQ#########################WWWWW#   ###
#     ^                             #     #      #
#     ^                       ###   #  S  #      #
# 1   ^  S                 P  # #   #     #      #
#     ^                       ###   #     #      #
#     ^                             #     #      #
 ##### ##############################     #      #
#        WQWQ ^                           #      #
#        WQWQ ^                           #      #
#   3    WQWQ ^      S             S      #      #
#        WQWQ ^                           #      #
 ############# #######EEEEE################      #
#             #                  #               #
#         S   #       S          #   k      S    #
#             #                  #               #
#   S  s      #         ####     #               #
#                       #                  #     #
#         S             # h                #  h  #
#                       #                  #     #
 ####################### ################## ##### 