                                                  
                                                  
                                                  
                                                  
                                                  
                                                  
                                                  
                     ^@@@@@@^                     
                    ^        ^                    
                   ^          ^                   
                  ^            ^                  
                  ^            ^                  
 #######          ^            ^          ####### 
#       #          ^          ^          #       #
#        #          ^        ^          #        #
#         ####      ^        ^      ####    a    #
#  G          #     ^        ^     #             #
#              #    ^        ^    #              #
#               #####        #####        a      #
#    d                                           #
#                                  a             #
#                        S                       #
#                s                               #
#      S                                    #   # 
#                                           #   # 
#                         d           S     #   # 
#           s                               #   # 
# q                                         # P # 
#                                           #   # 
 ########################################### ###  