 @@@@@@@@@@@@@@@@@@@@@@@@@@@@@@@@@@@@@@@@@@@@@@@@
#................................................#
#     S                                          #
#                           S                    #
#                                                #
#           R                                    #
#                                                #
#                                                #
#                    G                           #
#    R                                           #
#                         S                      #
#                                                #
#                                                #
#                                    G           #
#                                                #
#              G                                 #
#                                                #
#   R                      S                     #
#                                                #
#                                                #
#                                                #
#                      G                         #
#                                                #
#                                                #
#                                  G             #
#                                                #
#                                                #
#                      P                         #
#                                                #
 ################################################