 ##################@@@@@@@@@##################### 
#                                                #
#                                                #
#                      R                         #
 ##################         ##################### 
#                                                #
#                      R                         #
 ##################         ##################### 
#                                                #
#                      R                         #
 ##################         ##################### 
#                                                #
#                      R                         #
 ##################         ##################### 
#                                                #
#                      R                         #
 ##################         ##################### 
#                                                #
#                      R                         #
 ##################         ##################### 
#                                                #
#                      R                         #
 ##################         ##################### 
#                                                #
#                      R                         #
 ##################         ##################### 
#                                                #
# P                                              #
#                                                #
 ################################################ 