##################################################
#                                                #
#    /                               /           #
#                        /                       #
#                                                #
#            /                                   #
#   /                                            #
#                                      /         #
#                       %                        #
#                                                #
#    /                                           #
#                                                #
#                                     /          #
#                /                               #
#                                                #
#     /                                          #
#                                                #
#                                                #
#              /              /                  #
#                                                #
#                                                #
#                                                #
#                                         /      #
#                                                #
#        /             /                         #
#                                                #
#                             /                  #
#                                                #
#                                                #
##################################################