#                        ######################### 
#                       #                        #
#                       #  P                     #
 ########################                        #
@#                     ##        G            M  #
@                       #                        #
@   G         G  #      #                        #
@        #              #                        #
@#                      ##################       #
 ^^^^^^#         #^^^^^^#                        #
#      #         #      #                        #
#      #         #      #                 G      #
#      #    G    #      #                        #
#      #         #      #    M                   #
#      #         #      #                        #
#      #         #      #                        #
#      #         #      #                        #
#      #         #      #       ################# 
#      #   G     #      #                        #
#      #         #      #     G                  #
#      #         #      #                        #
#      #         #      #                        #
#      #         #      #                M       #
#      #     G   #      #                        #
#      #         #      #                        #
 ^^^^^^#         #^^^^^^##################       #
#                                                #
#       G           G            G               #
#                                                #
 ################################################ 