    #                                       #@@@# 
    #                Y                     #     #
    #                                      #     #
    #                                      #     #
 ### ^^^^^^^^^^^^^^^^^^^^^^^^^^^^^^^^^^^^^^#     #
#   #                                      #     #
# 3 #                                      #     #
#   #                                      #     #
#...#                                      #     #
#                                          #     #
#                                          #     #
#                                          #     #
#                                          #     #
#                                          #     #
#                                          #     #
#                                          #     #
#WWWWWW^^^^^WWWWWWWWWWWWWWWWWWWWWWWWWWWWWWW#     #
#      ^   ^                               #     #
#      ^ 2 ^                               #     #
#      ^   ^                               #     #
#WWWWWW^^^^^WWWWWWWWWWWWWWWWWWWWWWWWWWWWWWW#     #
#                                          #     #
#                                          #     #
#                                          #     #
#                                          E     #
#                                          E     #
#                                          E     #
#                        P                 E     #
#                                          E     #
 ################################################