                   #@@@@@@@@#                     
                   #        #                     
                   #        #                     
 ###################        ##################### 
#                  ..........                    #
#                                                #
#                                                #
#                                                #
#                                                #
#                                                #
#                                                #
#                                                #
#                                                #
#                                                #
#                      M                         #
#                                                #
#                                                #
#                                                #
#                                                #
#                                                #
#                                                #
#                                                #
#                                                #
#                                                #
#                                                #
#                                                #
#                                                #
#                       P                        #
#                                                #
 ################################################ 