 ##### ########## ###     #@@@@@#     ########### 
#     #          #   #   #       #    #          #
#     #              #  #         #   #     R    #
#                    # #  R     R  #  #          #
# P          #   R   ##      R      ########     #
#         R  #       #                           #
#            #       #                           #
#     #      #       #             R   ########## 
#     #      #       #                 #         #
#     #   R  #   R   ######                  R   #
#     #      #       #                           #
#     ########       #            #        ###### 
#     #              #     ########              #
#     #          R   #     #                     #
#     #              #     #                 R   #
#     ####################################       #
#                                        #   R   #
#  R           R              R          #       #
#                                        #       #
#     ####################################       #
#             #      #                           #
#    R        #      #      R             R      #
#      R      #      #                           #
 ###     ######      ##################     ##### 
#             #      #            #              #
#                    #            #              #
#     R          R   #      R     #       R      #
#                                                #
#             #             R                    #
 ############# ################################## 