################################################## 
#                                                #
#                                                #
#                                                #
#    3                                  4        #
#                                                #
#                                                #
#                                                #
#^^^^^^^^^^^^^^                    ^^^^^^^^^^^^^^#
#                                                #
#                                                #
#               2                                #
#                                                #
#                                                #
#                                                #
#                                                #
#                                                #
#                                                #
#                                                #
#                                                #
#                                                #
#                                                #
#     1                                          #
#                                                #
#                                                #
#                                                #
#                                                #
#                                                #
#                                                #
##################################################