 @@@@@@@@@@@@@@@@@@@@@@@@@@@@@@@@@@@@@@@@@@@@@@@@
#................................................#
#                                                #
#     J                     J                    #
#                                                #
#           S                                    #
#                                                #
#                                                #
#                    G                           #
#    S                                           #
#                         J                      #
#                                                #
#                                                #
#                                    G           #
#                                                #
#              G                                 #
#                                                #
#   S                      J                     #
#                                                #
#                                                #
#                                                #
#                      G                         #
#                                                #
#                                                #
#                                  G             #
#                                                #
#                                                #
#                      P                         #
#                                                #
 ################################################