       ########################################## 
#     ^                                          #
#  1  ^                            S             #
#     ^                                          #
 ######      ###########################         #
#     #      #     #                   ^         #
# ### #      #  2  # 3                 ^         #
# # # #      #     #                   ^         #
# ### #      #                 #########         #
#     #      #                 ^                 #
#  P  #  S   #       d      ^^^^              ### 
#     #      #^^^^^  d      ^                 QWE@
#     #      #     # j ^^^^^^      S          QWE@
#     #      #     # f ^    ^                 QWE@
#     #      #     # g ^    ^                 QWE@
#     #      #     # g ^    ^                 QWE@
#     #      #     # f ^    ^          S      QWE@
#     #      #     # j ^^^^^^                 ### 
#     #      #     # d      ^                    #
#     #      #     # d      ^^^^                 #
#     #      #     #           ^                 #
#     #      #  S  ###############       #       #
#     #      #                   #       #       #
#     #      #           S       #   s   #       #
#     #      #                   #       #       #
#     #      #     #             #########       #
#            #     #                             #
#     S      #  S  #                   S         #
#            #     #                             #
 ############ ##### ############################# 