 #######################################
#                                      #
#                  R       R           #
#            R                         #
#    R         #                       ########## 
#              #                                 @
#              #                                 @
#              #     R          R                @
#         R    #                       ########## 
#    R         #                       #
#              #            R          #
#              #                       #
#     ######### ####################### ######### 
#     #                #               #         #
#     #      R         #        R      #   jgd   #
#     #####                                jgd   #
#                #      R       #     R    jgd   #
#                #              #                #
#     ########################################## 
#                                                #
#    R                                   R       #
#                                                #
#            R                R                  #
#                                                #
 ########################################        #
#                                                #
#   R             R                              #
#                        P              R        #
#                                                #
 ################################################ 