 ################################################ 
#                                                #
#                    P                           #
#                                                #
#                                                #
#          #                                     #
#          ###################################### 
#          #                                     #
#                 G            G                 #
#                      G                      G  #
#                      G                         #
#                 G            G                 #
#                                                #
#                                          #     #
 ###########################################     #
#                                          #     #
#   G                   G          G             #
#          G                                  G  #
#                  #        #                    #
 ###################        ##################### 
#               #           #                    #
#   G           #           #                 G  #
#        #  a   #           #              #     @
#        #   j  #       G   #      M       #     @
#        #      #           #              #     @
#   G    ########           #              #     @
#                                          #     @
#    G           G               G         #  G  #
#                                          #     #
 ########################################## ##### 