#@@@@@@@@@@@@@@@@@@@@@@@@@@@@@@@@@@@@@@@@@@@@@@@@#
#                                                #
#    I                                     I     #
#                                                #
#                     ^^^^^                      #
#         ^^^^^^^^^^^^     ^^^^^^^^              #
#        ^                        ^^^^           #
#       ^            #        J      ^           #
#       ^                           #^^^^        #
#     ^^^                               ^        #
#    ^       J                          ^        #
#    ^  #                               ^^^^^    #
#    ^                                      ^    #
#    ^               #      J          #    ^    #
#    ^                                      ^    #
#    ^                                ^^^^^^     #
#    ^      #                         ^^^^^^     #
#    ^                                      ^    #
#     ^^^^        J    #               J    ^    #
#        ^                                  ^    #
#          ^                      #  ^^^^^^^     #
#           ^^^^^                    ^           #
#                ^^^^^^^^^^^^^^^^^^^^            #
#                                                #
#                                         I      #
#  I                                             #
#                                                #
#                        O                       #
#                                                #
##################################################