 ################################################
#                                                #
#  V                   V                  V      #
#             V                                  #
#                           V                    #
#      R                               R         #
# P                  V                           #
#                                                #
#                                          V     #
#         G           .......                    #
#                     . @@@ .       G            #
#                     .@   @.                    #
#    V                .@   @.                    #
#            V        .@   @.            V       #
#                     .@   @.                    #
#                     .@   @.                    #
#       S             . @@@ .     R              #
#            V        .......              V     #
#                                                #
#                               S                #
#     R         V                      V         #
#                                                #
#                                                #
#            S         R       V                 #
#                                             V  #
#                                  R             #
#       R                    V                   #
#                V                        V      #
#                                                #
 ################################################