


 #######################@@@######################
#                                                #
#                                                #
#                                                #
#                                                #
#      ^^^^^                          ^^^^^      #
#      ^   ^                          ^   ^      #
#      ^   ^                          ^   ^      #
#      ^   ^                          ^   ^      #
#      ^^^^^                          ^^^^^      #
#                                                #
#                                                #
 ###################          ################### 
#                                                #
#                                                #
#                                                #
#                                                #
#                                                #
#                                                #
#                                                #
#                                                #
#                                                #
#                                                #
#                                                #
#                       P                        #
#                                                #
##################################################