##################################################
#                                                #
#   P                                            #
#                                                #
#                                                #
#                                                #
#                                                #
#                                                #
#          L                                     #
#                                                #
#                                                #
#                                                #
#                                                #
#                                                #
#                                                #
#          @                                     #
#                                                #
#                                                #
#                                                #
#                                                #
#                                                #
#                                                #
#          E                                     #
#                                                #
#                                                #
#                                                #
#                                                #
#                                                #
#                                                #
##################################################