 @@@@@@@@@@@@@@@@@@@@@@@@@@@@@@@@@@@@@@@@@@@@@@@@ 
#                                                #
#                                                #
#                                                #
#                                                #
#         H                          H           #
#                                                #
#                                                #
#                                                #
#                                                #
#                                 H              #
#                                                #
#                                                #
#                                                #
#         H                                      #
#                                                #
#                                                #
#                                                #
#                                H               #
#                                                #
#                                                #
#                                                #
#                                                #
#                                                #
#                                                #
#                                                #
#                                                #
#                      O                         #
#                                                #
 ################################################ 