 ##### ########## ############################### 
#     #          #                               #
#  h  #   R      R                  R          f #
#     #                   R                      #
#     #      #       #     #################     #
#     #      #       #                           #
#     #   R  #       #    R    R              R  #
#     #      #       #                           #
#            #       ######      ################ 
#    R   R   #       #                           #
#            #   R   #  R              R    R    #
 #############       #            #              #
#                    #     ########        R     @
#    R     R     R   #  k  #                     @
#                    #     #           R         @
#   R ############### ####################       @
#                    #                   #       @
# R        R         # j  R              #       @
#                    #                   #       #
#     #########      ##########       ####       #
#                    #                           #
#          R         #    R        R         R   #
#                    #                           #
 ##############      ############################ 
#                    #            #              #
#                    #       R    #     R        #
#      R             #            #           d  #
#  d          #    R  P        R         R       #
#             #                                  #
 ############# ################################## 