##################################################
#                                            d   #
#        R                                   d   #
 ######     #####################################
#                         #                      @
#                         #   d                  @
# P                       #   d     G            @
#                         #   d                  @
#                         #                      @
 ####################    ##########     #########
#  j            j   #           #           hhff #
#  j            j   #           #           hhff #
 #########   ############     # #    ############
#      #         #     #        #      #         #
#                #              #                #
#          R     #         G    #           G    #
#                #              #                #
#      #         #     #        #      #         #
 #   ## ###########   ####################     ##
#      #     #                                   #
#            #              R                    #
#         R  #                           G       #
#   R        #    R                              #
#      #     #                                   #
#      #########################     ############
#                                                #
#                   G                            #
#       G                         G              #
#                                                #
 ################################################