 ################################################ 
#                   #                            #
#                   #                       G    #
#    G              #           #                #
#                      G        #     G          #
#          #                    #         #   #  #
#    G     ################################   ### 
#          #       #                      #   #  #
#                  #                             #
#                  #####                         #
#                      #     G              G    #
#    G              G  #                         #
#                      #                         #
#                #     #                   #     #
 #################     #####################     #
#                #     #                   #     #
#   G               G  # aa  G                   #
#                      #                  G      #
# #   #             #########                    #
 ##   ###############       ################     #
# #   #         #                                #
#               #         G               G      #
#        #      #                                #
#        #  aa  #    G              G      #     #
#  P     #      #           G              #     #
#        ########                          #     #
#           #                              #     #
#           #        G          G          #  g  #
#           #                              #     #
 ########### ############@@@@@@@########### ##### 