 ################################################ 
#                                         Q      #
#    G                       G            Q      #
#                 G                       Q      #
#                                         Q      #
#     #####################################      #
#     #                                   #      #
#     #   S                     S         #      #
#     #                S                  #      #
#     #                                   #      #
#     #     #########################     #      #
#  G  #     W                       #     #      #
#     #     W                 @@@   #     #      #
#     #     W         S       @ @   #     #  R   #
#     #     W                 @@@   #     #      #
#     #     W                       #     #      #
#     ###############################     #      #
#                                   E     #      #
#                        G          E     #      #
#  3            G              G    E     #      #
#                                   E     #      #
 ##########################################      #
#             #                  #               #
#   #####     #  R               #          R    #
#   #   #     #                  #               #
#   #   #  P  #         ####     #               #
#   #   #               #                  #     #
#   #####               # 2                #  1  #
#                       #                  #     #
 ####################### ################## ##### 