 ################################################ 
#                                                #
#                                                #
#         M                     M                #
#                                                #
#                         M                      #
#    M                                         P #
#                  M                             #
#                                                #
#                                                #
#       ######################################### 
#                                                #
#   M                     R           R          #
#                 R                              #
#                                                #
 #######################################         #
#                       ^                        #
#                                   G            #
#                                                #
#                       ^                        #
#          L            #    G                G  #
#                       #                        #
#                       #               .........#
#                       #         G     .@@@@@   #
#                       #               .@@@@@   #
 ###################    #               .@@@@@   #
#                       #               .@@@@@   #
# w                     #    G          .@@@@@   #
#                       #               .        #
 ####################### ######################## 