 @@@@@@@@@@@@@@@@@@@@@@@@@@@@@@@@@@@@@@@@@@@@@@@@
#................................................#
#     S                                          #
#                           S                    #
#                                                #
#           R                                    #
#                                                #
#                                                #
#                    G             J             #
#    R                                           #
#                         S                      #
#        J                                       #
#                                                #
#                                    G           #
#                                                #
#              G                                 #
#                                     J          #
#   R                      S                     #
#                                                #
#                                                #
#                                                #
#                      G                J        #
#    J                                           #
#                                                #
#                                  G             #
#                                                #
#                                                #
#                      P                   J     #
#                                                #
 ################################################