 @@@@@@@@@@@@@@@@@@@@@@@@@@@@@@@@@@@@@@@@@ ###### 
#                                         ^      #
#                                         ^      #
#                          I              ^      #
#                                         ^      #
#      H                                  ^      #
#                                        ^       #
#                        ^^^^^^^^^^^^^^^^^       #
#                       ^                        #
#                     ^       #                  #
#                     ^                       #  #
#                    ^                           #
#                    ^ #            J            #
#                     ^                          #
#                      ^       #                 #
#                     ^                          #
#                     ^                          #
#                      ^^^^^^^^              #   #
#       H                     ^                  #
#                             ^^^^^^^^^^^^^      #
#                                  ^             #
#                                  ^^^^^^^^^^^^^ # 
#                                             ^  #
#                                             ^  #
#                                    I        ^^ #
#                                               ^#
#                                                # 
#        O                                       #
#                                                #
 ################################################ 